to appreciate - ценить
relatives - родственники, родные
pale - бледный, тусклый
noble - благородный
to yawn - зевать
glance - взгляд
veil - вуаль
to sob - рыдать, всхлипывать
den - логово, притон
absence - отсутствие
to twitch - дёргаться
to exhaust - изнурять, истощать
modest - скромный, ограниченный
purpose - цель, назначение, задача
to pluck out - вырывать
to accompany - сопровождать
within - в пределах, внутри
indeed - действительно, в самом деле
cheerful - весёлый, жизнерадостный
disgust - отвращение
steep - крутой, резкий, отвесный
gap - зазор, разрыв, пробел
hollow - полый, пустой, впалый
thick - толстый, густой
to bow - кланяться, склонять
to bend - гнуть, покорять, покоряться
chin - подбородок
beside - рядом, около
brazier - жаровня, мангал
fist - кулак
unkempt - неопрятный
to sink - тонуть, погружаться
to owe - задолжать кому-либо
passage - переход, проход, прохождение
narrow - узкий, тесный
stupefying - дурманящий
fume - дым, испарение
light-house - маяк
crooked - изогнутый, кривой
to astonish - удивлять, поражать
dull - тусклый, скучный
to approach - подходить, приближаться
to refuse - отказывать кому-либо, отвергать что-либо
request - запрос, требование
definitive - окончательный, исчерпывающий, отличительный
imperative - повелительный
however - однако, тем не менее
certain - определённый, конкретный
to straighten - выпрямить, выровнять, расправить
burst - взрыв, всплеск
prey - добыча, жертва
inquiry - запрос, расследование
whistle - свист, свисток
to conduct - проводить, осуществлять, руководить
to put off - откладывать (на потом)
to put on - надевать, набирать
to put forward - выдвигать, предлагать, высказывать
to put up with - смириться с чем-либо
chain - сеть, цепь, вереница
beneath - внизу, под, низко
sorely - очень, тяжко, мучительно
to interrupt - прерывать, приостанавливать, перебивать
suburban - пригородный 
somehow - как-то, почему-то
brief - краткий, короткий, сжатый, лаконичный
amount - сумма, количество, объём
to receive - получать что-либо
parcel - посылка, пакет, участок
considerable - значительный, существенный 
anxious - тревожный, встревоженный, беспокойный
frantically - судорожно, неистово, отчаянно
to wave - махать, размахивать
irresistable - неотразимый, непреодолимый 
necktie - галстук
to convince - убеждать кого-либо
cripple - калека, инвалид
to tear - рвать, рваться, отрывать
lid - крышка, веко
evident - очевидный, явный, наглядный
plain - простой, обычный, ясный, очевидный
boot - ботинок, сапог, бутса
stain - пятно, краска
sill - подоконник, порог
villain - злодей, преступник, негодяй
accessory - аксессуар, принадлежность, соучастник 
to deny - отрицать, отказывать
lodger - жилец, постоялец
beggar - нищий, бедняк, попрошайка
to pretend - притворяться, делать вид, представлять 
tiny - маленький, крошечный
stock - запас, склад
to pave - прокладывать, мостить, покрывать
pavement - тротуар, дорожное покрытие, мостовая
charity - благотворительность, милосердие 
leather - кожа
acquaintance - знакомство, знакомый, приятель
scar - шрам, рубец
outer - внешний, наружный
edge - край, грань, окраина
common - общий, обычный, единый, простой
feather  - перо, пёрышко
to sparkle - сверкать, блестеть
to faint - падать в обморок
sense - смысл, чувство, ощущение
sight - взгляд, вид
fault  - вина, неисправность, дефект, неполадка, брак, недочёт
to remedy  - устранять, исправлять
suspicious - подозрительный, недоверчивый
claim - заявление, иск, претензия
to claim - утверждать что-либо, претендовать на что-либо
to remain - оставаться
pocket - карман, скопление
to sweep - мести, вычищать, чистить
victim - жертва, пострадавший
innocent - невинный, невиновный
to suspect - подозревать кого-либо/что-либо
witness - свидетель, очевидец
outskirts - окраина, предместья
counties - округа, графства, уезды
besides - кроме, кроме того, помимо
either - также, тоже, либо
frankly - откровенно, честно
envelope - конверт, оболочка
ink - чернила, тушь, краска
seal - уплотнение, печать, знак, уплотнитель
to seal - запечатывать что-либо
to chew - жевать, пережёвывать что-либо
unless - если не, только если, если только
forgery - подлог, подделка, фальшивка
to discourage - отговаривать, обескураживать
to thrust - засовывать кого-либо, что-либо
to get rid of - избавиться от чего-либо, кого-либо
cosy - уютный, удобный
to disturb - беспокоить кого-либо, мешать кому-либо
inn - трактир, гостиница
convict - преступник, осуждённый, заключённый
to accuse - видвигать обвинения против, упрекать
to supply - поставлять, снабжать
to hold out - дотягивать, протягивать
to distinguish - различать, отличать, распознавать
obvious - очевидный, явный
to tie - завязывать, связывать
at all - совсем, совершенно
forceps - пинцет, щипцы, клещи
lens - линза, объектив
shabby - поношенный, потёртый
to shatter - раздробить, разрушить, разбиться вдребезги
to chuckle - усмехаться, хихикать
cupboard - шкаф, шкафчик, буфет
to carry out - осуществлять, выполнять что-либо
threat - угроза, опасность
to fulfil - выполнять, исполнять, осуществлять что-либо, соответствовать чему-либо
suitcase - чемодан
agility - ловкость, быстрота, проворство
at once - сразу, тотчас
accidental - случайный, непредвиденный, непреднамеренный
will - желание, воля, завещание
to argue - утверждать, рассуждать, возражать, заявлять
to disturb - беспокоить, мешать, тревожить
estate - недвижимость, усадьба, поместье
draughts - шашки
speckled - пятнистый, пёстрый, в крапинку, испещрённый
objection - возражение, протест, несогласие
due - благодаря, из-за, по причине, в связи с
to fetch - приносить, извлекать
cunning - хитрость, коварство
sole - подошва
joy - радость, веселье, восторг
to kneel - преклонить колени, встать на колени
damp - влажный, сырой, мокрый
triffle - мелочь, пустяк
inarticulate - неразборчиво
to confess - исповедоваться, признаваться
waistcoat - жилет
pillow (cushion) - подушка
to brag - хвастаться, хвалиться, кичиться
mug - кружка, чашка
enormous - огромный, колоссальный, небывалый, невероятный, громадный
delight - удовольствие, восторг, радость
temper - темперамент, нрав, характер
to hiss - свистеть, шипеть
saucer - блюдце, подставка, тарелка
rope - верёвка, канат, трос
income - доход, доходы, прибыль
howling - вой, завывание
lawn - газон, лужайка, батист
to dare - отваживаться
to mop - мыть, драить, убирать
mop - швабра, копна, шевелюра
indifferently - равнодушно, безразлично
ceiling - потолок
feature - функция, особенность, характерная черта
statement - высказывание, отчёт, заявление, утверждение
vain - пустой, тщеславный, напрасный
to insist - настаивать, утверждать
injury - травма, вред, повреждение
to shave - бриться, брить, сбривать
sleeve - рукав
gloomy - мрачный, угрюмый, хмурый
to carry - нести, возить, таскать
sharply - резко, решительно
coarsely - грубо, приблизительно
to protrude - выходить, выступать наружу
tattered - изорванный, оборванный, драный
forehead - лоб
jug - кувшин
bark - кора
to obey - повиноваться, подчиняться
destiny - судьба, участь
to resemble - походить на кого-либо, быть похожим на кого-либо
cellar - погреб, подвал
slit - прорезь, щель, разрез
to amuse - развлекать кого-либо
faithful - верный, преданный
shade - оттенок, тень
tint - оттенок, тон
chestnut - каштан
cockroach - таракан
right away - сразу
carpenter - плотник, столяр
to deserve - заслуживать
moustache - усы
interrogation - допрос, дознание
facial - лицевой
admiration - восхищение, восторг
fondness - пристрастие, любовь
handcuffs - наручники
coolness - хладнокровие, невозмутимость
collar - воротник, ошейник
handling - обработка, обращение, управление
to preserve - оберегать, сохранять
precaution - мера предосторожности
purse - кошелёк, сумка, денежный фонд
to pat - похлопывать, шлёпать
despair - отчаяние, безысходность
grief - горе, скорбь, печаль
jerk - рывок, толчок
broad - широкий, обширный, полный
gash - рана, надрез, прорезь
spark - искра, огонёк, проблеск
glint - блеск, вспышка
stern - суровый, жёсткий
lantern - фонарь, лампа, светильник
to baffle - препятствовать, мешать кому-либо, сбивать с толку
magnificent - великолепный, прекрасный, восхитительный
hedge - изгородь, ограда
rage - ярость, гнев
treasure - сокровища, клад, драгоценность
branch - филиал, отделение, отрасль, ветвь
bold - смелый, дерзкий, отважный
weariness - усталость, утомление
affection - любовь, привязанность, симпатия
wistful - задумчивый, тоскливый, меланхоличный
digestion - пищеварение, переваривание, усвоение
beyond - за, за пределами, вне, сверх
intruder - злоумышленник, нарушитель
to pursue - преследовать, продолжать, гнаться за кем-либо
belly - живот,брюхо
flesh - плоть, мясо
to hint - намекать
to arise - возникать, появляться, подниматься
to cease - прекращать, приостанавливать
leap - скачок, прыжок, прорыв
chase - погоня, преследование, охота
to snarl - рычать, огрызаться
rifle - винтовка, карабин, ружьё
meantime - тем временем, между тем
grip - захват, сцепление, контроль, хватка
conscious - осознанный, сознательный
unbearable - нестерпимый, невыносимый
mitten - варежка, рукавица
thus - таким образом
arrogance - высокомерие, надменность
vain - пустой, тщеславный, напрасный
anticipation - ожидание, предвидение, предвкушение
deliberate - преднамеренный, умышленный, обдуманный, взвешенный
brute - зверь, животное
to starve - голодать, морить кого-либо
lean - тощий, худой
corresponding - соответствующий, подобный
advance - прогресс, наступление
menacing - зловещий, угрожающий, опасный
dubious - сомнительный, неопределённый
nostril - ноздря
wound - рана, ранение, обида
remnant - остаток, пережиток
plenty - множество, обилие, избыток
fierce - свирепый, ожесточённый, жестокий
savage - дикарь, варвар, грубиян
abreast - в ряд, на одной линии
harness - сбруя, упряжь
obstacle - преграда, препятствие, помеха
breed - порода, род, племя, сорт
caressing - ласковый
cub - детёныш
squeal - визг, скрип, вопль
entire - весь, целый
lynx - рысь
porcupine - дикобраз
nevertheless - всё-таки, всё же
jealous - ревнивый, завидующий
to persuade - склонять, убеждать, уговаривать
sigh - вздох
to embrace - обниматься, обнимать, обхватывать
midst - середина, средь, посреди
curiosity - любопытство, любознательность
slope - склон, спуск, наклон, скат
hostile - враждебный, недружелюбный
obedience - послушание, повиновение, покорность
therefore - поэтому, таким образом, так что
remuneration - вознаграждение, оплата, гонорар
mere - простой, чистый
to bury - закапывать, хоронить, зарывать
claw - коготь, клешня
revenge - реванш, месть, отмщение
rapid - бурный, быстрый, стремительный, оперативный
legacy - достояние, наследие, наследство
to forbade - запрещать, не позволять
painstaking - кропотливая работа
lair - логово, берлога
barely - едва, мало, лишь
populous - густонаселённый, многолюдный
to lurk - таиться, скрываться
soothing - успокаивающий, смягчающий
somewhat - немного, в некоторой степени
apparently - очевидно, видимо, по-видимому
tribe - племя. род, клан
beaver - бобр, бобёр
to wilt - вянуть, поникнуть
endurance - выносливость, прочность, стойкость
invariably - неизменно, постоянно
vengeance - возмездие, месть
outcast - изгнанник, изгой
to get along - обходиться, ладить, найти общий язык
to wail - вопить, причитать, выть, стенать
to sorrow - скорбеть, горевать
sacred - святой, священный, сакральный
sore - болячка, рана, ранка
bruise - синяк, гематома, кровоподтёк
likewise - также, аналогично
to stumble - спотыкаться, оступаться, ошибаться
to utter - произносить, проговаривать
mournful - грустный, жалостливый, горестный
to afflict - огорчать, беспокоить, тревожить
dense - густой, плотный, непрозрачный
wrath - гнев, ярость
outlet - выход, розетка, отвод, торговая точка
to detain - задерживать, удерживать
morose - угрюмый, замкнутый
to enforce - обеспечивать исполнение, приводить что-либо в исполнение
invincible - непобедимый, несокрушимый
to surrender - сдаваться, капитулировать
to descend - спускаться, сходить, снизойти до чего-либо
to bare - оголять, обнажать
to bristle - топорщиться
concrete - бетон, цемент
ancestor - предок, родоначальник, предшественник
primacy - примат, первенство, верховенство
to tame - укрощать, усмирять, приручать
dim - тусклый, мутный, приглушённый
to postpone - откладывать, переносить
fierce - свирепый, ожесточённый, жестокий
to swallow - глотать, сдерживать, подавлять
to groan - стонать, охать
to grunt - хрюкать, ворчать
oblong - продолговатый, вытянутый
sled - сани, санки, упряжка
eternity - вечность, бесконечность
merit - заслуга, достоинство
to endure  - выдержать, вытерпеть, пройти через что-либо
solitary - одиночка, отшельник
jealousy - ревность, зависть
taut - натянутый, подтянутый, упругий
whip - плеть, кнут хлыст
strap - ремень, ремешок
covenant - завет, пакт, соглашение
participant - участник
shambles - руины, разруха, развалины
to resent - возмущаться, негодовать
joyous - радостный, весёлый, довольный
vaguely - смутно, туманно, неточно
regard - внимание, почтение, забота
faith - вера, вероисповедание
dignity - достоинство, сан, гордость
collocation - словосочетание, коллокация
malice - злоба, злость
scrawny - костлявый, тощий
thoroughly - тщательно, основательно
splendid - великолепный, прекрасный, роскошный
to mould - отливать, формировать, лепить
bitter - горький, суровый, жестокий
scatter - разброс, разбег
to offend - оскорбить, обидеть
offender - преступник, нарушитель
stroke - ход, удар, инсульт
clumsy - неуклюжий, неповоротливый
steamer  - пароход, отпариватель
manifestation - проявление, манифестация
to exceed - превышать, превосходить
profit - доход, прибыль, выгода
praise - похвала, хвала, восхваление
loose - свободный, рыхлый, распущенный, просторный
former - бывший, прежний, предыдущий, прошлый
torment - мука, мучение, терзание
to tease - дразнить, разжигать интерес, подначивать
to reign - царствовать, править, преобладать
to cling - цепляться, льнуть, облегать, держать, прилипать
deck - палуба, площадка
to sever - разорвать, оборвать, порвать, отрезать
to estimate - оценивать, прикидывать
sober - трезвый, сдержанный, рассудительный
fidelity - верность, точность, преданность, чёткость
to redeem - выкупать, искуплять
shivering - дрожь, озноб, дрожание
treachery - предательство, подлость, вероломство
loose - свободный, рыхлый, распущенный
reluctant - вынужденный, неохотный, нерасположенный
indomitable - неукротимый, несгибаемый, упрямый
to loosen - рыхлить, ослаблять
muzzle - морда, намордник, дуло
apprehension - опасение, понимание, задержание
to glare - сверлить взглядом
decisive - решительный, окончательный, решающий
to snuggle - прижиматься, уютно устраиваться, прислоняться
to suffocate - захлёбываться, задыхаться
revolt - восстание, бунт, мятеж
bedding - постельное бельё
irritable - раздражительный
to vanish - исчезать, пропадать, стремиться к нулю
to expose - раскрывать, выявлять, выставлять, обнажать
squat - корточки, приседание
haste - поспешность, спешка, торопливость
marvellous - чудесный, замечательный, изумительный
to grasp - понять, улавливать, постигать, схватывать
to duck - нырять, уворачиваться, наклонять
to dodge - уклоняться, изворачиваться, избегать
prosperous - процветающий, благополучный, зажиточный
to irritate - раздражать, сердить, злить
slight - лёгкий, небольшой, незначительный
allegiance - верность, преданность
inevitable - неизбежный, неотвратимый
malignant - злокачественный, злобный, вредоносный
harsh - суровый, резкий, жёсткий, грубый
sane - разумный, вменяемый, здравый
indignation - возмущение, негодование
violation - нарушение, надругательство, насилие
furthermore - кроме того, также, к тому же
to distort - искажать, искривлять, деформировать
coward - трус, трусиха
muddy - илистый, грязный, мутный
stick around - оставаться поблизости, держаться рядом
powder - порошок, пудра, порох
disdain - презрение, пренебрежение
prolonged - длительный, продолжительный, продлённый
marvel - чудо, диво
to declare - заявлять, объявить
refuge - убежище, прибежище
snare - ловушка, западня
vaguely - смутно, туманно, неточно
regard - внимание, почтение, забота
custom - обычай, традиция, привычка
namely - а именно, то есть, конкретно
survey - опрос, обследование, исследование
preference - предпочтение, преимущество
to acknowledge - подтверждать, сознавать
starvation - голодание, голод, истощение
pasture - выгон, пастбище
to dismount - снимать, разбирать, демонтировать, спешиваться
wholehearted - искренний, беззаветный
quizzical - шутливый, насмешливый, вопросительный
elusive - неуловимый, ускользающий
drowsiness - сонливость, вялость
to loathe - ненавидеть, презирать, отрицательно относиться
sufficient - достаточный, надлежащий
to adjust - регулировать, корректировать, настраивать
to admit - признавать, допускать, принимать
chamber - палата, камера, комната
swift - быстрый, стремительный, скорый
to pace - шагать, расхаживать, идти шагом
to employ - использовать, нанимать, трудоустраивать
to woo - свататься, ухаживать, добиваться расположения
to summon - вызывать, призывать
rescue - спасение, освобождение
precise - точный, конкретный, чёткий
peculiar - своеобразный, особый, необычный, особенный
to endeavour - стремиться, пытаться, прилагать усилия
presumably - предположительно, вероятно
insensibly - незаметно, неощутимо
incisive - острый, язвительный, колкий, проницательный
languid - вялый
to implicate - вовлекать, впутывать, делать кого-либо причастным
to quench - утолять, гасить, заливать, тушить
shelter - приют, убежище, укрытие
rumble - гул, грохот, шум
discretion - благоразумие, усмотрение, осмотрительность
ado - суматоха
rampage - буйство, ярость, неистовство, бешенство
sneeze - чиханье, чих
obstinacy - упорство, упрямство
curb - бордюр, бортик, обочина
hoof - копыто
trifling - незначительный, пустячный, плёвый
riot - бунт, беспорядки, буйство
figment - вымысел, фикция
remorse - раскаяние, сожаление
to holler - кричать, вопить
to confide - доверять, поручать
to conceal - скрывать, таить
to hurl - метать, бросать, швырять
to condescend - снисходить, унижаться
ado - суматоха
rampage - буйство, ярость, неистовство
sneeze - чиханье, чих
obstinacy - упорство, упрямство
curb - бордюр, бортик, обочина
hoof - копыто
chamois - замша
betrothal - обручение, помолвка
resolute - решительный, непоколебимый
reproach - укор, упрёк
errand - поручение, задание
to waylay - подстерегать, устраивать засаду
to ransack - грабить, обыскивать, искать
indiscretion - неосмотрительность, неосторожность
to entangle - путать, запутывать кого-либо/что-либо
docket - выписка, перечень, вести книгу записей
garbage - мусор, отбросы
pathos - пафос, энтузиазм, трогательность
recon - разведка, проводить разведку
to adopt - принимать, усыновлять
trifling - незначительный, пустячный, плёвый
imperfection - несовершенство, дефект, недостаток
to refrain - воздерживаться, удерживаться
vile - гнусный, мерзкий, подлый
hence - следовательно, поэтому, таким образом
to scrape - царапать, скрести, чистить
extortion - вымогательство, побор, шантаж
to kidnap - похищать
to depict - обрисовывать, отображать
to kidnap - похищать
incorrigible - неисправимый
trifle - мелочь, пустяк, чуть-чуть
wedlock - брак, супружество, законный брак
vague - смутный, туманный, расплывчатый
compelled - вынужденный, принуждаемый, подчинённый
preposterous - нелепый, абсурдный
to emerge - возникать, появляться, выясняться
to disguise - маскировать, скрывать
guise - наружность, облик, обличье, вид
inextricable - неразрывный, неразрешимый, запутанный
reckoning - счёт, расплата
feast - праздник, пир, торжество
sinister - зловещий, злой, тёмный
decay - распад, упадок, разложение
ominous - зловещий, жуткий, угрожающий
idler - бездельник, лентяй
dashing - сильный, энергичный
dainty - изысканный, изящный, утончённый
to assess - оценивать, рассматривать
to necessitate - требовать, повлечь за собой, делать необходимым
to beam - сиять, излучать, широко улыбаться
to vouch sb./sth. - поручиться за кого-либо, что-либо
deceit - обман, лживость, хитрость, уловка
appetiser - закуска, аперитив
sewer - канализация, коллектор, швея
burden - бремя, нагрузка, груз
foe - враг, противник, неприятель
brink - грань, край, берег, граница
to forsake - покинуть, оставить, отказаться от, бросать, отрекаться от
peril - опасность, риск, угроза
to mend - чинить, штопать, исправлять
trinket - брелок, безделушка, мелочь
void - пустота, вакуум, полость, пробел
detour - объезд, обход
gaze - взгляд, взор
to discern - разглядеть, различать
meadow - луг, поляна
pillage - грабёж, мародёрство, разграбление
horde - орда, толпа, полчище
to repel - отразить, отбивать, отражать, отталкивать
to foresee - предвидеть, предугадать, предусматривать
to unleash - высвободить, развязывать, выпускать
to dwell - обитать, жить, пребывать, останавливаться
fading - увядание, угасание
breach - нарушение, брешь, пролом, разрыв
to falter - дрогнуть, замедляться, спотыкаться, запинаться
to wane - убывать, иссякать, ослабевать, угасать
to forfeit - потерять право на, лишаться, утрачивать
oath - клятва, присяга, обет
wicked - злой, нечестивый, коварный, подлый
vulnerable - ранимый, уязвимый, чувствительный
massacre - резня, бойня, массовое убийство
to linger - задерживаться, оттягивать, мешкать, бездельничать
to perish - погибать, исчезать, портиться
courtesy - вежливость, учтивость, любезность
woe - горе, скорбь, беда, несчастье
herald - вестник, глашатай, предвестник
tide - прилив, течение, поток
to plunge - погружаться, окунать
mercenary - наёмник
incredible - невероятный, потрясающий, неимоверный
awesome - удивительный, отличный, великолепный
heathen - язычник, дикарь, варвар, безбожник
pledge - залог, обещание, обязательство
to seek - искать, стремиться, добиваться, просить, обращаться за
eve - канун, преддверие
to hasten - спешить, торопиться, ускорять
tread - ступень, поступь, походка
wretch - негодник, мерзавец, подлец
henceforth - отныне, впредь, в дальнейшем
collation - сопоставление, сверка, сравнение, проверка
to shrink - уменьшаться, сморщиться, усыхать
to weep - плакать, рыдать, запотевать
comprehension - осмысление, понимание, восприятие, постижение
to anticipate - предвидеть, ожидать, предвкушать
fugitive - беглец, эмигрант, беженец
deed - дело, документ, поступок
testimony - свидетельство, показание, доказательство
epitome - краткое изложение, воплощение, конспект
apron - фартук, передник, авансцена
to assemble - собирать, монтировать, сооружать, созывать
to supplant - вытеснять кого-либо/что-либо
subtle - тонкий, изысканный, ловкий
inquisitive - любознательный, пытливый, любопытный
to convey - передавать, выражать, транспортировать
to interfere - препятствовать, вредить
glimpse - проблеск, мелькание, быстрый взгляд
filth - грязь, скверна, мерзость, запущенность
aisle - проход, коридор, отсек, придел
to rot - гнить, портиться, разлагаться
slaughter - убой, забой, бойня, резня, убийство
captive - пленник, пленный
to stink - вонять, смердеть, быть отвратительным
acute - резкий, острый, сильный, точный, проницательный
benevolent - благожелательный, доброжелательный, великодушный
amiable - дружелюбный, любезный, приятный
formidable - грозный, внушительный, страшный, трудный
ally - союзник, соратник
ambush - засада, западня, укрытие
peasant - крестьянин, простолюдин
to aspire - стремиться, стараться, претендовать
spear - копьё, острога, дротик
quarry - каменоломня, карьер, добыча
nasty - мерзкий, противный, неприятный
bog, marsh, swamp - болото, болотистая местность, топь, трясина
to warrant  - гарантировать, оправдывать, ручаться
to dampen - гасить, мочить, приглушать, смягчить
to diminish - уменьшать, снижать
lament - плач, причастие, сожаление
to skew - искажать
wisp - пучок, обрывок, клочок
foul - нечистый, гадкий, грязный
inane - бессмысленный, глупый, бессодержательный
succinct - ёмкий, краткий, сжатый
gratitude - благодарность, признательность
stirring - перемешивание, взбалтывание, размешивание
riddle - загадка, тайна, ребус
odd - нечётный, странный, необычный
scuffle - драка, потасовка
rattle - трещотка, погремушка, грохот
gleam - отблеск, блеск
capable - способный, умелый
to relieve - освобождать, облегчать, уменьшать
farewell - прощание
bid - предложение, заявка, ставка
proceeding - процедура, процесс, разбирательство
solemn - торжественный, священный
awkward - неловкий, неудобный, неуклюжий
pagan - язычник, нехристь
shrine - святилище, храм, святыня
worship - поклонение, богослужение, почитание
to fathom - понимать, постигать, осознавать
accomplice - сообщник, соучастник, подсобник
uproar - шум, беспорядки, волнение
to rejoice - радоваться, ликовать, торжествовать
to assure - убеждать, гарантировать
cellular - клеточный, сотовый, сетчатый
to curl - виться, завивать
mercy - милость, милосердие, сострадание
to confound - разрушить, сбить с толку, приводить в замешательство
genuine - истинный, искренний, подлинный, настоящий
nudge - толчок, подталкивание
scarce - дефицитный, редкий, недостаточный
to perceive - воспринимать, чувствовать, ощущать
rumour - слух, молва, толки
to ensnare - заманивать, поймать в ловушку
fabulous - сказочный, потрясающий
to ditch - выбросить, избавиться от
grudge - обида, злоба, неприязнь
recess - тайник, углубление, перерыв
entourage - антураж, окружение, свита
in demand - пользующийся спросом
to gain - получать, добиваться, завоёвывать
to regain - возвращать, восстанавливать
precipitance - стремительность, поспешность, опрометчивость
grim - мрачный, суровый, печальный
relapse - рецидив, обострение, повторение
consistent - последовательный, стабильный, устойчивый
to devour - поглощать, пожирать
celestial - небесный
tough - прочный, трудный, сложный, жёсткий
to evaluate - оценивать, давать оценку, составлять мнение
to hail - приветствовать, провозглашать
slumber - дрёма, сон, дремота
sincere - искренний, откровенный
to resign - отказываться, уходить в отставку, слагать полномочия
appointment - должность, назначение, приём, встреча
to abandon - отказываться от чего-либо, оставлять, покидать, бросать
emerald - изумруд
hindrance - помеха, препятствие, преграда
imprudent - неосторожный, неосмотрительный
shutter - жалюзи, затвор, заслонка
to dismantle - демонтировать, разбирать, сносить
otherwise - иначе, иным образом, по-другому
terrain - местность, территория, район
vital - важный, жизненный, существенный
consumption - потребление, расход, использование
to encircle - окружать, охватывать, опоясывать
utmost - максимальный, крайний, предельный
cordial - радушный, сердечный
relish - удовольствие, пристрастие, смак
humdrum - будничный, заурядный, однообразный
bizarre - причудливый, странный, необычный
to withdraw - изымать, отзывать, забирать, уходить, отводить
abrupt - крутой, резкий, обрывистый, неожиданный
to content with - довольствоваться, довольный чем-либо
to persist - упорствовать, сохраняться, настойчиво продолжать
narrative - повествование, рассказ, история
plug - штекер, вилка
pin - штифт, штырь, значок, булавка
labour - труд, работа
drab - серость, однообразие
pompous - напыщенный, помпезный
obese - брюзгливый, тучный, жирный
to bear - нести, выдерживать, терпеть, переносить
intrusion - вторжение, внедрение
vow - обет, клятва
to contribute - делать вклад, жертвовать, способствовать
insult - оскорбление, обида
subsidiary - филиал, дочерняя компания, подразделение
chagrin - досада, огорчение, сожаление
to stagger - шататься, покачиваться
sample - образец, проба, выборка, модель
immense - огромный, колоссальный, необъятный
thorough - тщательный, основательный, обстоятельный
curriculum - учебный план, курс обучения
peer - сверстник, ровня, коллега
to boast - гордиться, хвастаться, похваляться
to unwind - разматывать, расслабляться, развеяться
sneer - глумление, насмешка
gibe - колкость, издёвка
abhorrent - вызывающий отвращение
akin - схожий, сходный, родственный
to predominate - возвышаться
eclipse - затмение, потускнение
surgeon - врач, хирург
wreckage - обломки, крушение, авария
to impose - налагать, накладывать, облагать
ignorant - невежественный, необразованный, безграмотный
stinging - покалывание, жжение
susceptible - предрасположенный, восприимчивый, чувствительный
longing - стремление, тоска, тяга
soil - почва, грунт, земля
to flourish - процветать, преуспевать, расцветать
to slay - убить, умертвить, сразить
to suppress - подавлять, сдерживать
quail - перепёлка, куропатка
porch - крыльцо, веранда, паперть
to desert - оставлять, дезертировать, покидать
grave - серьёзный, веский, тяжкий
culprit - виновник, преступник
hen - курица
fence - забор, ограждение, ограда, изгородь
affectionate - ласковый, любящий, нежный
to cheer up - развеселить, ободрить
affair - дело, роман, инцидент
bald - лысый, плешивый
neat - аккуратный, опрятный, лаконичный, чёткий
reed - тростник, камыш
tenant - арендатор, съёмщик
overcast - пасмурная погода, сплошная облачность
endangered - вымирающий, исчезающий
to endanger - подвергать опасности, ставить под угрозу
stove - плита, печь, духовка
cutlery - столовые приборы
scenery - пейзаж, декорации, сцена
to retire - отступить, уходить на пенсию (в отставку)
benefit  - благо, преимущество, польза, выгода
jumble - нагромождение, беспорядок, путаница
to betray - предавать, подводить
moist - влажный, мокрый, дождливый
to catch up - догнать, наверстать упущенное
cloak - плащ, покров, мантия
bargain - сделка, соглашение, договор
milestone - веха, этап, контрольная точка
agenda - повестка дня, программа, план мероприятий
mill - мельница, фабрика
stiff - тугой, плотный
torque - момент, крутящий момент, момент силы
flaw - недостаток, изъян, дефект
vicious - порочный, злой, злобный
candid - искренний, откровенный, беспристрастный
cliff - утёс, скала, обрыв
orchard - (фруктовый) сад
to sprout - отращивать, давать всходы, распускаться
to acquire - приобретать, овладевать
wage - зарплата, заработок
to pawn - закладывать, оставлять в залог
to wriggle - изгибаться, извиваться, кривляться
eligible - соответствующий, годный
to entitle - называть, озаглавливать, давать право
bequest - завещание, наследие, наследство
obliging - любезный, услужливый
vice - порок, недостаток
trustee - доверенное лицо, попечитель, управляющий
crib - детская кроватка, колыбель
handy - удобный, сподручный, полезный
interest - процент, интерес
to accrue - нарастать, увеличиваться, доставаться
berth - причал, должность
confine - предел, граница
shutters - жалюзи, ставни, створки
to tramp - бродить, тяжело ступать
barrow - тачка, тележка
vivid - яркий, живой
dejected - подавленный, разочарованный
pinch - щепотка, щипок
to wring - крепко сжимать, скручивать, выжимать
bashful - застенчивый, стыдливый
to seize - хватать, налагать арест
to tug - тащить, тянуть
to deceive - обманывать, вводить в заблуждение
benefactor - благотворитель, благодетель, меценат, покровитель
to lengthen - удлинять, вытягивать
to budge - сдвинуть, шевелиться
hoax - мистификация, обман
fraud - мошенничество, фальсификация
anyhow - во всяком случае, во что бы то ни стало, как бы то ни было
diligence - усердие, трудолюбие, прилежание, осмотрительность
cardboard - картон
to dissolve - растворять, распускать, расторгать
curt - отрывистый, краткий, резкий
rueful - жалкий, печальный, горестный
to shove - толкать, отталкивать
accountant - бухгалтер, счетовод
solicitor - адвокат, юрисконсульт
grievance - жалоба, недовольство
lad - мальчик, отрок
gypsy - цыган, цыганка
applicant - кандидат, соискатель, заявитель
to comprise - включать, составлять, заключать в себе
to thrive - процветать, преуспевать, благоденствовать
instance - экземпляр, пример, случай
to beg - попрошайничать, упрашивать
to spare - экономить что-либо, обходиться без чего-либо
dingy - покрытый сажей, грязный, выцветший
enclosure - корпус, ограждение, огороженное пространство
gilt - золочёный, позолоченный
to thump - колотить, стучать, бить
vigorous - энергичный, сильный, решительный
to enrol - записываться, регистрировать, вносить в список
retired - в отставке, отставной, уединённый
swarm - рой, толпа
conundrum - парадоксальная ситуация, головоломка, загадка
rehearsal - репетиция, повторение
bait - наживка, приманка, прикорм
merit - заслуга, достоинство
gently - слегка, нежно, мягко, осторожно
sleuth - сыщик, ищейка
relentless - неумолимый, непреклонный, безжалостный, неустанный
alternately - поочерёдно, попеременно
astuteness - проницательность, дальновидность
contemplative - созерцательный, медитативный
languor - расслабленность, томность
amid - среди, между
lust - похоть, жажда, вожделение
pottery - гончарное дело, керамика, гончарные изделия
bulb - лампочка, лампа, колба
fossil - ископаемое, окаменелость
pastime - времяпровождение, занятие, развлечение
oppressed - угнетённый, подавленный
nocturnal - ночной
rack - стойка, шкаф, стеллаж, полка, вешалка
lofty - возвышенный, высокомерный
devotee - поклонник
apparel - одежда, одеяние, наряд
lace - кружева, тесьма, шнурок
cork - пробка, поплавок
warehouse - склад, складское помещение, хранилище
stake - ставка, доля, часть
orphanage - сиротский приют, детский дом
to hum - напевать под нос, жужжать, фонить
virtue - добродетель, достоинство, преимущество
tenacious - цепкий, живучий, упорный, настойчивый, крепкий
thoroughfare - магистраль, транспортная артерия, оживлённая улица
to terminate - прекращать, прерывать
piled - нагромождённый
crate - ящик, контейнер
minutely - скрупулёзно, подробно
to suffice - быть достаточным, подходить для чего-либо
foil - фольга, плёнка
bullion - слиток золота/серебра
misgiving - опасение, дурное предчувствие
to crouch - согнуться
to subdue - подчинять, покорять, ослаблять, подавлять
dank - промозглый, сырой, влажный
bulky - громоздкий, большой, массивный
chink - щель, скважина
to rend - терзать, раздирать, рвать
to peep - выглядывать, смотреть в щёлочку
keenly - внимательно, очень, заинтересованно
aperture - отверстие, проём, диафрагма
to haul - тащить на буксире, тянуть
lithe - гибкий
chisel - долото, зубило, резец, стамеска
to clutch - зажимать, сжимать, схватить
bland - слабый, безвкусный, пресный, мягкий
pal - приятель, друг, товарищ
to clatter - греметь, грохотать, громыхать, лязгать
serene - безмятежный, спокойный, невозмутимый
ample - просторный, обширный, богатый, достаточный
ingenious - остроумный, искусный, находчивый, изобретательный
to lure - привлекать, приманивать, соблазнять
rogue - разбойник, жулик, мошенник
to incite - подстрекать, провоцировать
elaborate - продуманный, тщательный, замысловатый
to ascertain - констатировать, устанавливать, выяснять
skirmish - стычка, перестрелка, перепалка
burrow - нора, ход, пустая порода
to abut - прилегать, граничить
ennui - скука, тоска, апатия
unfeigned - искренний, неподдельный, непритворный
prominent - выдающийся, известный, видный
to thrill - будоражить, захватывать, волновать
timid - пугливый, застенчивый, робкий
to intimidate - запугивать, пугать, устрашать
elated - ликующий, окрылённый
to associate - объединяться, связывать
associate - партнёр, коллега, соратник
untimely - несвоевременный, преждевременный
to blink - мигать, моргать, щуриться
to wander - блуждать, бродить, странствовать
outset - начало, начальный этап
to unravel - распутывать, разгадывать
to submit sth. - представлять что-либо на рассмотрение
intimate - задушевный, близккий, личный
pitiable - плачевный, достойный жалости
premature - преждевременный, досрочный, поспешный
haggard - измождённый, изнурённый, измученный
forearm - предплечье
violent - резкий, сильный, агрессивный
to encompass (sb./sth.) - охватить, включать в себя, окружить (кого-либо/что-либо)
coastal - прибрежный, береговой, приморский
stunned - ошеломлённый, потрясённый
dumbfounded - ошарашенный, ошеломлённый
awe - трепет, благоговение
crutch - костыль, опорка, подпорка
petrified - окаменевший, окаменелый
decent - достойный, приличный, порядочный
dissolute - развратный, распутный
eventually - в итоге, со временем, в конце концов
gambler - азартный игрок
pauper - бедняк, нищий
to obtain - получать, приобретать, достигать, добиваться
imprisonment - заключение, лишение свободы
to bequeath - завещать, передавать по наследству
to reside - проживать, находиться
to indulge - баловать, потакать, потворствовать
hereditary - потомственный, наследственный
disgraceful - позорный, постыдный, возмутительный
brawl - драка, потасовка, ссора
to avert - предотвращать что-либо
to whiten - отбеливать, седеть
fortnight - две недели
to deprive sb. of sth. - лишать кого-либо чего-либо
to allure - манить, привлекать, очаровывать
feeble - немощный, слабый, невыразительный
sturdy - прочный, крепкий
solid - прочный, массивный, цельный, плотный
hefty - здоровенный, огромный, крупный
fragile - хрупкий, ранимый, уязвимый
crow - ворон, ворона
dedication - преданность, самоотверженность, посвящение
to proceed - действовать, происходить, продолжать
congestion - перегруженность, затор, закупорка
van - фургон, вагон
spatula - шпатель, лопаточка
fluent - свободный, беглый
impending - неминуемый, надвигающийся
to recollect sth. - вспоминать что-либо
hubbub - шум, гомон
gale - шторм, буря
shawl - платок, шаль
to revolve - вращаться, крутиться, переворачиваться
to grope - идти на ощупь, нащупывать
to choke - задыхаться, душить
charred - обугленный, обгоревший
notorious - пресловутый, известный, знаменитый
chimney - дымоход, труба
allusion - упоминание, указание, намёк
spotted - пятнистый, крапчатый
to pierce - протыкать, прокалывать, пробивать
thrill - острые ощущения, волнение, трепет
frill - оборка, жабо
to fringe - обрамлять, окаймлять
thumb - большой палец
crackling - потрескивание, треск
agricultural - сельский, аграрный
breadth - ширина, широта
apparition - явление, видение, призрак
scoundrel - негодяй, подлец, мерзавец
draught - сквозняк, тяга
to meddle - вмешиваться, лезть не в свои дела
insolence - наглость, дерзость, нахальство
imprudence - неосторожность, безрассудство
pittance - гроши, незначительная часть
to fold - складывать, согнуть, сворачивать
to timber sth. - обшивать что-л. деревом
grove - роща, рощица
gable - фронтон, щипец
mansion - особняк, усадьба
fare - тариф, стоимость проезда
to erect - строить, возводить, сооружать
alteration - изменение, перестройка, правка
firm - прочный, устойчивый, крепкий, строгий
hinge - шарнир, петля
perplexity - недоумение, растерянность
wicker - плетёный
tassel - кисточка, закладка
brisk - бодрый, свежий, оживлённый, быстрый
dummy - манекен, муляж, пустышка, фальшивка
compulsory - обязательный, принудительный
appalling - ужасающий, страшный, отталкивающий
porcelain - фарфор
dough - тесто
reverie - задумчивость, мечтательность
compliance - соответствие, соблюдение, согласие
pretence - притворство, претенциозность, отговорка, предлог
to undo sth. - отменять, расстёгивать что-л.
hasp - засов, застёжка
tangible - ощутимый, осязаемый, материальный
dusk - сумерки, закат, сумрак
to loom - маячить, появляться, мерещиться
hoarse - хриплый, сиплый, охрипший
scruple - сомнение, колебание, угрызения совести
distinct - выраженный, особенный, отдельный, отчётливый
coincidence - совпадение, случайность, стечение обстоятельств
nerve - нерв, мужество, сила духа, хладнокровие
seething - бурлящий, кипящий
livid - взбешённый, в бешенстве
to extinguish sth. - тушить, гасить, аннулировать что-л.
chill - холод, озноб, прохлада
sombre - мрачный, тёмный, печальный
clump - комок, клок, группа
to dart sth. - метать, кидать
hideous - отвратительный,омерзительный, чудовищный
to affect sb./sth. - затрагивать, воздействовать на кого-л./что-л.
cane - тростник, трость
vigil - бодрствование, дозор, бдение
stump - пень, обрубок, огарок
ray - луч, излучение
parish - приходской, церковный
to befall sb. - произойти с, приключаться с кем-л.
to succeed (sb./sth.) - добиться успеха, преуспевать, сменить кого-л.
to strain sth. - напрягать что-л.
audible - звуковой, слышимый, акустический
jet - струя, поток
kettle - чайник, котёл
to lash sb. - стегать, хлестать кого-л.
swell - увеличение, припухлость, возвышение
mingle - мешанина, смесь
parsonage - пасторат, дом священника
appeal - привлекательность, обращение, обжалование, призыв, апелляция
naughty - озорной, непослушный, капризный
handle - ручка, рукоятка, рукоять
ajar - приоткрытый
clad - оедтый, плакированный
lap - колени, раунд, заезд, круг
to rear (sb./sth.) - разводить, выращивать, воспитывать кого-л.
to puff - дымить, отдуваться, пыхтеть
serpent - змея (книжн.), змей
adder - гадюка
to recoil - отпрыгивать, отскакивать
schemer - интриган
noose - петля
horrid - страшный, отвратительный, неприятный
to prolong sth. - продлевать что-л.
erroneous - ошибочный, неверный
to reconsider sth. - пересматривать что-л.
ruthless - беспощадный, безжалостный
to dispel sth. - развеять, рассеять что-л.
incoherent - безсвязный, непоследовательный, некогерентный
questionable - сомнительный, спорный
lapse - период, промежуток, ошибка, провал, описка
to allude to sth. - ссылаться на, намекать на что-л.
perversion - искажение, извращение
to condense (sth.) - сгущать, конденсировать что-л.
subsequent - последующий
retain sth. - сохранять, удерживать, поддерживать что-л.
supreme - верховный, высший, величайший
conventional - обычный, традиционный, общепринятый
to scramble - карабкаться, бороться
knuckle - костяшка, сустав пальца
dispensable - несущественный, незначительный, необязательный
to propose (sth.) - предлагать, выдвигать что-л.
to pervade (sth.) - пронизывать, распространяться, наполнять что-л.
pinnacle - вершина, башенка, пик
summit - саммит, вершина, верх
placid - спокойный, безмятежный
congenial - подходящий, благоприятный
endowed - наделённый, одарённый
treatise - трактат, научный труд
vogue - мода, популярность
strain - штамм, напряжение, нагрузка, растяжение
to shroud sth. - накрывать, прикрывать что-л.
winding - обмотка, извилина, изгиб
quiver - колчан, вибрация, трепет, дрожь
bail - залог, порука, поручительство
to devise - разрабатывать, изобретать
to weave (sth.) - плести, ткать что-л.
ripe - зрелый, спелый, созревший
wily - лукавый, хитрый, коварный
toils - сети, западня
to strive - стремиться, прилагать усилия
contest - конкурс, соревнование, соперничество
fairly - достаточно, довольно, справедливо
to oscillate - колебаться, качаться, вибрировать
conceivable - мыслимый, возможный, вообразимый, постижимый
to overthrow sb. (sth.) - свергнуть, низвергнуть кого-л. что-л.
to rinse sth. - промывать, ополаскивать, полоскать что-л.
intercept - перехват
to enhance sth. - повышать, расширять, увеличивать, улучшать что-л.
canteen - столовая, буфет, кафетерий
daft - безрассудный, легкомысленный, глупый
to incommode - мешать, беспокоить, стеснять
to inconvenience sb. - беспокоить, причинять кому-л. неудобства
to hamper sth. - препятствовать, мешать, сдерживать что-л.
treat - удовольствие, угощение
grapple - захват, борьба, схватка
neglect - пренебрежение, игнорирование, запустение
plot - участок, сюжет, заговор
wand - палочка, жезл
willow - ива, верба, ивняк
detention - задержание, арест, содержание под стражей
charming - очаровательный, обаятельный, прелестный
whilst - пока, в то время как, тогда как
fickle - непостояннный, переменчивый, ненадёжный
spooky - зловещий, жуткий
dormitory - общежитие, общая спальня
proven - проверенный, признанный, испытанный
goblet - бокал, кубок, чаша
tricky - сложный, хитрый, коварный, запутанный
pumpkin - тыква, болван
aggrieved - пострадавший, обиженный
to strangle - душить, задушить
vermin - паразиты, вредители
assault - штурм, нападение, насилие
slate - шифер, сланец
preparatory - подготовка, приготовление
bludgeon - дубинка, дубина
custody - опека, опекунство, тюремное заключение
retiring - скромный, застенчивый
conspicuous - заметный, бросающийся в глаза, примечательный
potion - зелье, микстура, настойка
devastation - разорение, опустошение, разруха
bonnet - капот, чепчик, крышка
wee - крошечный, маленький
suspension - подвеска, суспензия, приостановка, прекращение
rendezvous - свидание, место встречи
to impel (sb./sth.) - побуждать, вынуждать, стимулировать кого-л.
to clamber - карабкаться, взобраться
salient - важный, заметный, выступающий
triage - сортировка
preliminary - предварительный, начальный
unprecedented - беспрецедентный, небывалый, невиданный
to imply sth. - подразумевать, означать, влечь за собой что-л.
forensic - судебный, криминалистический, судебно-медицинский
to exploit (sb./sth.) - эксплуатировать, разрабатывать, использовать кого-л./что-л.
to this end - с этой целью, в этих целях
to implement (sb./sth.) - осуществлять, реализовывать, внедрять что-л.
sophisticated - изысканный, сложный, изощрённый
to overcome (sth.) - охватывать, преодолевать что-л.
insidious - коварный, вероломный
malicious - вредоносный, злоумышленный, злонамеренный
to distribute sth. - распространять, распределять что-л.
denial - отказ, отрицание
to deteriorate (sth.) - ухудшаться, разрушаться
contestant - участник, конкурент, соперник
willing - желающий, готовый, добровольный
to jam (sth.) - заклинить, заглушить что-л.
fearsome - страшный, зловещий
to roam (sth.) - бродить, ходить по чему-л.
blast - взрыв, ударная волна
to flee (sb./sth.) - бежать, спасаться бегством, избегать кого-л./что-л.
misleading - обманчивый, ложный, вводящий в заблуждение
to blab - разбалтывать, болтать
cubicle - кабина, кабинка
distraught - смятённый, обезумевший
to mangle (sb./sth.) - катать, калечить, искажать что-л.
persuasive - убедительный
capture - захват, поимка, взятие
sorcerer - колдун, маг, чародей
venom - яд, злоба
fitting - монтаж, установка, сборка
award - награда, премия, приз, вознаграждение
resourcefulness - находчивость, изобретательность
to suspend sth. - приостанавливать, подвешивать, откладывать что-л.
concern - концерн, озабоченность, обеспокоенность
welfare - благосостояние, благополучие, социальное обеспечение
severe - суровый, жестокий, сильный, тяжёлый
cauldron - казан, котёл, котелок
injuction - судебный запрет, предписание
to procure sth. - закупать, обеспечивать, снабжать, доставать что-л.
to alight - высаживаться, садиться
venerable - досточтимый, почтенный, достопочтенный
priest - священник, поп, жрец
porter - носильщик, портье
decrepit - дряхлый, ветхий
resigned - покорный, послушный
ecclesiastic - духовное лицо, священнослужитель
to droop (sth.) - обвисать, унывать, склонять что-л.
to startle - напугать, испугать
cassock - сутана, ряса
intolerable - недопустимый, невыносимый
pursuer - преследователь
by no means - никоим образом, ни в коей мере
inadmissible - непозволительный, неприемлемый, недопустимый
whereabouts - местонахождение, местоположение
to divulge sth. - разглашать, раскрывать, оглашать что-л.
raving - буйный, бредовый, бушующий
aboard - на борту, на борт, на
to befuddle - одурманивать, опьянять
to consent to sth. - разрешить, соглашаться с, позволять что-л.
disquiet - беспокойство, тревога, волнение
to disrupt sth. - разрушать, нарушать что-л.
divination - гадание, прорицание, предсказание
wonky - шаткий, ненадёжный
omen - предзнаменование, знак
wimp - бесхарактерный человек, обыватель, тряпка
oaf - болван, дурак
joint - соединение, сустав, стык
to venture - рисковать, отваживаться
incantation - заклинание, заговор
to assume (sth.) - предположить, считать, предполагать, брать на себя что-л.
to reflect sth. - отражать что-л.
feat - подвиг, достижение, мастерство
prior - предыдущий, предшествующий
prior to - до, до момента
to elect (sb./sth.) - избирать, выбирать кого-л./что-л.
to restrain (sb./sth.) - сдерживать, ограничивать, задерживать кого-л./что-л.
insufferable - невыносимый, нетерпимый
ignorance - невежество, незнание, неведение
parchment - пергамент
emphasis - акцент, упор, значение
contraction - сокращение, сжатие
peaky - бледный, измождённый
pile - ворс, куча, свая, груда
grate - решётка, тёрка, сетка
to cope (sth.) - справиться, пережить, преодолевать что-л.
scrutiny - проверка, тщательное исследование, внимательный осмотр
to dislodge (sb./sth.) - вытеснять, смещать кого-л./что-л.
ridge - хребет, гребень, гряда
crane - кран, журавль
wrench - ключ, гаечный ключ, вывих
mischief - озорство, шалость, проделки
superior - начальство, начальник
wit - остроумие, ум, смекалка
lump - кусок, ком, шишка
to conjure - колдовать
to sack sb. - уволить, вышвырнуть кого-л.
spare - запасной, резервный, свободный, худой
as though - будто, точно
deaf - глухой, неслышащий
astounded - изумлённый, удивлённый, поражённый
to shrivel (sth.) - сокращать, ссыхаться, сморщиваться, вызывать увядание чего-л.
desperate - отчаявшийся, отчаянный
to cleave sth. - разрубить, раскалывать что-л.
disposal - распоряжение, утилизация, уничтожение
hereinafter - в дальнейшем, ниже, здесь и далее
to condemn (sb./sth.) - осудить, приговорить, признать что-л. негодным
hunch - догадка, толчок, чутьё
shack - лачуга, хижина, хибара
rag - ветошь, тряпка
flicker - мерцание, мелькание, вспышка
watchfulness - бдительность, наблюдательность, настороженность
exuberant - энергичный, возбуждённый
to recur - повторяться, возвращаться
equanimity - невозмутимость, хладнокровие
superficial - поверхностный, внешний
to omit sth. - опустить, пропустить, упускать что-л.
hamlet - хутор, деревня
torrent - поток
to melt (sth.) - растопить, плавить что-л.
tremendous - огромный, потрясающий, колоссальный, ужасный
shaft - вал, ось, шахта
chasm - пропасть, бездна, расщелина
depth - глубина, полнота
to brim (sth.) - наполнять что-л. до краёв
onward - далее, дальше, вперёд
giddy - головокружительный, легкомысленный
whirl - вихрь, водоворот, круговерть
clamour - шум, шумиха
pit - карьер, яма, котлован, впадина
flea - блоха
to chop sth. - рубить, порезать что-л.
chime - куранты, перезвон, звон
ghastly - жуткий, ужасный
to retrace (sth.) - проследить, восстанавливать что-л. в памяти
hut - хижина, изба
ferret - хорёк
fastidious - прихотливый, разборчивый
gutter - жёлоб, канава
bunk - койка, кормушка
malcontent - оппозиционер, недовольный человек
codger - чудак
aptitude - пригодность, способность, склонность, соответствие
torture - пытка, истязание, мучение
demented - безумный, сумасшедший
pathetic - жалкий, трогательный, душераздирающий, ничтожный, жалостный
dimwit - дурак, тупица
to hoist sth. - поднимать что-л.
chalice - потир, церковная чаша
vessel - судно, сосуд, корабль, резервуар
to hoodwink - обманывать, вводить в заблуждение
haemorrhage - кровотечение, кровоизлияние
consolation - утешение
physician - врач, доктор, медик, терапевт
lead - свинец, лидерство, поводок, главная роль
to reverberate - отдаваться, многократно отражать звук, отражаться
sheer - настоящий, абсолютный, отвесный, сущий
to daze sb. - ошеломить, потрясти кого-л.
alas - увы
incessant - непрестанный, непрекращающийся
to plough sth. - бороздить, вспахивать что-л.
patch - патч, заплатка, участок
fern - папоротник
fringe - бахрома, грань, периферия, чёлка
to bedraggle - испачкать, замарать
to spout - разглагольствовать, хлестать, литься
for the time being - пока, пока что, на время
to unfold sth. - раскрыть, развернуть что-л.
quirk - причуда, странность
rabid - дикий, неистовый, бешеный
vastly - очень, чрезвычайно, безмерно
dizzy - головокружительный, чувствующий головокружение
rebel - бунтарь, бунтовщик
to intercept sb./sth. - перехватывать кого-л./что-л.
entrant - участник, абитуриент, кандидат
to comb sth. - расчёсывать, причёсывать что-л.
exhilarating - бодрящий, захватывающий, волнующий, головокружительный, возбуждающий
badge - значок, жетон, символ
greasy - жирный, засаленный
sawdust - опилки
frivolity - легкомыслие, фривольность, легкомысленность
foremost - прежде всего, в первую очередь
to besmirch - пачкать, порочить, запятнать
fella - человек
grit - песок, гравий, твёрдость характера
loquacious - словоохотливый, говорливый, болтливый
bowlder - валун, булыжник
to flutter - развеваться, трепетать
sketch - эскиз, набросок, зарисовка, описание
disposition - расположение, характер, распоряжение, диспозиция, нрав
swirling - бурление, завихрение, кружение
foam - пена, пенопласт, дым
injudicious - неразумный, неблагоразумный, необдуманный
drain - дренаж, сток, канализация
admittedly - по общему признанию, предположительно
skull - черепной
turnip - репа, репка
weed - сорняк, трава, водоросль
innate - врождённый, прирождённый, природный
fiber - волокно, нить, ткань
bunch - букет, пучок, гроздь, связка
consequential - косвенный, побочный
wretched - жалкий, несчастный, никудышный
to overwhelm (sb./sth.) - подавлять, овладевать, поражать кого-л./что-л.
herb - трава, растение, пряность
innocuous - безобидный, безвредный
maze - лабиринт, дебри
wary - настороженный, осторожный, осмотрительный
to renounce (sb./sth.) - отказаться от, отречься от кого-л./чего-л.
bond - связь, облигация, обязательство, узы
loopy - невменяемый
decree - указ, постановление, декрет
expulsion - исключение, выдворение, изгнание
pending - в течение, на время, вплоть до
outrageous - возмутительный, вопиющий, скандальный
dulcet - нежный, сладкий, приятный
paternal - отцовский, отеческий
felon - уголовник, преступник
to smear sth. - размазывать, мазать что-л.
warp - деформация, искривление
memo - памятка, меморандум, записка
to chuck sb./sth. - метать кого-л./что-л.
to wipe sth. - вытирать, обтирать, удалять что-л.
to prune sth. - подрезать, убирать что-л.
to prohibit sth. - запрещать что-л.
dismay - смятение, тревога, озабоченность
explicable - объяснимый, закономерный
prosecution - преследование, обвинение, предъявление иска
overwhelming - подавляющий, ошеломляющий, непреодолимый
incredulity - недоверчивость, скептицизм
utter - полный, крайний, абсолютный
to sustain sth. - выдерживать, поддерживать что-л.
to recapitulate - резюмировать, повторять, перечислять
to undergo sth. - проходить, подвергаться, претерпевать, переживать что-л.
so far as - поскольку, до тех пор, пока, до, при условии, что
mutual - взаимный, совместный
profound - глубокий, глубокомысленный, основательный
to depose (sb.) - сместить, допросить, опросить кого-л.
to mutilate - калечить, уродовать, увечить
conjecture - гипотеза, предположение
to inflict sth. - нанести, причинить что-л.
instantaneous - мгновенный, моментальный
to reconcile (sb.) - смириться, помирить кого-л.
to stroll - прогуливаться, гулять, бродить
obscure - смутный, неясный, малоизвестный
contempt - презрение, пренебрежение
throng - толпа, толчея
railing - перила, ограждение
wedge - клин
to hobble (sb./sth.) - мешать, хромать, ковылять, помешать кому-л./чему-л.
gruff - грубый, хриплый, резкий
sinewy - жилистый, мускулистый
seedy - убогий, сомнительный, изношенный
nonchalant - равнодушный, безразличный, небрежный
merchant - купец, торговец
tinge - оттенок, привкус, тон
